1111111111111111111111111111111111
1E0000000000C000C00000000000000001
1100101001000001C10010000000101011
1010010010101010001001000000010101
1P0000000C000000000001C10000000001
1111111111111111111111111111111111
